NO textures/Mona_Lisa.png
SO textures/Wheat_Field.png
WE textures/the_starry_night.png
EA textures/girl_with_a_pearl_earring.png
C 0,0,60
F 60,179,110


        11111111111111111111111111
        10000000001100000000000001
        10110000011 110000000000001
        100100000001000000N0000011
111111111011000001110000000000001
100000000011000001110111110111111
11110111111111011100000010001
11110111111111011101010010001
11000000110101011100000010001
10000000000000001100000100011
10000000000000001101010010001
1100000111010101111101111000111
11110111 10110101 11111010001
11111111 1111111 111111111111